######
#   D#
#  ###
# B # 
#P  # 
##### 