############
#        DD#
#   B      #
#P   B     #
#          #
############