#######################
#          #          #
#    BB    #    B     #
#P    B               #
#          #          #
############          #
           #DD      DD#
           ############