#######################
#                    D#
#   B   #       B     #
#       # P           #
#########   D  #D  B  #
        ###############