#################
#D             D#
#               #
#   #       #   #
#       B       #
#       B       #
#       B       #
#       B       #
#   #       #   #
#       P       #
#D             D#
#################